5,5,5,5,5,5,5,5,5,5,5,5,1017,1017,1017,1017,1017,1017,1017,1017,1017,5,5,5,5,5,5,5,5,5,5,5,5,5,5,5,5,5,5,5,5,5,5,5,5,5,5,5,5,5,5,5,5,5,5,5,5,5,5,5,5,5,5,5,5,5,5,5,5,5,5,5,5,5,5,5,5,5,5,5,5,5,5,5,5,5,5,5,5,5,5,5,5,5,5,5,5,5,5,5
5,5,5,5,5,5,5,5,5,5,5,5,5,0,0,0,0,0,0,0,5,5,5,5,5,5,5,5,5,5,5,5,5,5,5,5,5,5,5,5,5,5,5,5,5,5,5,5,5,5,5,5,5,5,5,5,5,5,5,5,5,5,5,5,5,5,5,5,5,5,5,5,5,5,5,5,5,5,5,5,5,5,5,5,5,5,5,5,5,5,5,5,5,5,5,5,5,5,5,5
5,5,5,5,5,5,5,5,5,5,5,5,5,0,0,0,0,0,0,5,5,5,5,5,5,5,5,5,0,0,0,0,5,5,5,5,0,0,0,0,0,5,5,5,5,5,5,5,5,0,0,0,5,5,5,5,5,5,5,0,0,0,0,0,5,5,5,5,5,5,5,5,5,5,0,0,0,0,0,5,5,5,5,5,5,5,5,5,5,5,5,0,0,0,5,5,5,5,5,5
5,5,5,5,5,5,5,5,5,5,5,5,5,1017,1017,1017,1017,1017,1017,5,5,5,5,5,5,5,5,0,0,0,0,0,5,5,5,0,0,0,0,0,0,0,5,5,5,5,0,0,0,0,0,0,0,5,5,5,5,5,0,0,0,0,0,0,0,5,5,5,5,5,5,5,5,0,0,0,0,0,0,0,5,5,5,5,5,5,5,5,5,5,0,0,0,0,0,5,5,5,5,5
5,5,5,5,5,5,5,5,5,5,5,5,0,0,0,0,0,0,0,5,5,5,5,5,5,0,0,0,0,0,0,0,0,0,5,0,0,0,0,0,0,0,0,5,5,0,0,0,0,0,0,0,0,0,5,5,0,0,0,0,0,0,0,0,0,0,0,5,5,5,5,5,0,0,0,0,0,0,0,0,0,0,5,5,5,5,5,0,0,0,0,0,0,0,0,5,5,5,5,5
5,5,5,5,5,0,0,0,5,5,5,0,0,0,0,0,0,0,5,5,5,5,5,5,5,0,0,0,0,0,0,0,0,0,0,0,0,0,0,0,0,0,0,0,0,0,0,0,0,0,0,0,0,0,0,0,0,0,0,0,0,5,5,0,0,0,0,0,5,5,5,0,0,0,0,0,5,5,0,0,0,0,0,5,5,5,0,0,0,0,0,5,5,0,0,0,5,5,5,5
5,5,5,5,0,0,0,0,0,5,0,0,0,0,0,0,0,5,5,5,5,5,5,5,0,0,0,0,0,5,5,0,0,0,0,0,0,5,5,5,0,0,0,0,0,0,0,0,5,5,5,0,0,0,0,0,0,0,0,0,5,5,5,5,0,0,0,0,0,0,0,0,0,0,0,5,5,5,5,0,0,0,0,0,0,0,0,0,0,0,5,5,5,0,0,0,0,5,5,5
5,5,5,0,0,0,0,0,0,0,0,0,0,0,0,0,5,5,5,5,5,5,5,5,0,0,0,0,0,5,5,5,0,0,0,0,5,5,5,5,5,5,0,0,0,0,5,5,5,5,5,5,0,0,0,0,0,0,5,5,5,5,5,5,5,5,0,0,0,0,0,0,0,0,5,5,5,5,5,5,0,0,0,0,0,0,0,0,5,5,5,5,5,5,0,0,0,5,5,5
5,5,0,0,0,0,0,0,0,0,0,0,0,0,0,5,5,5,5,5,5,5,5,5,0,0,0,0,0,0,5,5,5,5,0,5,5,5,5,5,5,5,5,0,0,5,5,5,5,5,5,5,5,0,0,0,0,0,5,5,5,5,5,5,5,5,5,0,0,0,0,0,5,5,5,5,5,5,5,5,5,0,0,0,0,0,0,5,5,5,5,5,5,0,0,0,0,5,5,5
5,5,0,0,0,0,0,0,0,0,0,0,0,5,5,5,5,5,5,5,5,5,5,5,5,0,0,0,0,0,0,5,5,5,5,5,5,5,5,5,5,5,5,5,5,5,5,5,5,5,5,5,5,5,5,5,5,5,5,5,5,5,5,5,5,5,5,5,5,5,5,5,5,5,5,5,5,5,5,5,5,5,5,5,5,5,5,5,5,5,5,5,0,0,0,0,0,5,5,5
5,5,0,0,0,0,0,0,0,0,0,0,5,5,5,5,5,5,6,6,6,5,5,5,5,5,0,0,0,0,0,0,5,5,5,5,5,5,5,5,5,5,5,5,5,5,5,5,5,5,5,5,5,5,5,5,5,5,5,5,5,5,5,5,5,5,5,5,5,5,5,5,5,5,5,5,5,5,5,5,5,5,5,5,5,5,5,5,5,5,5,5,0,0,0,0,5,5,5,5
5,5,0,0,0,0,0,0,0,5,5,5,5,5,5,5,5,6,6,6,6,6,5,5,5,5,5,0,0,0,0,0,0,5,5,5,5,5,5,5,5,5,5,5,5,5,5,5,5,5,5,5,5,5,5,5,5,5,5,5,5,5,5,5,5,5,5,5,5,5,5,5,5,5,5,5,5,5,5,5,5,5,5,5,5,5,5,5,5,5,5,0,0,0,0,5,5,5,5,5
5,5,0,0,0,0,0,0,0,5,5,5,5,5,5,5,5,6,6,6,6,6,6,5,5,5,5,5,0,0,0,0,0,0,5,5,5,5,5,5,5,5,5,5,5,5,5,5,5,5,5,5,5,5,5,5,5,5,5,5,5,5,5,5,5,5,5,5,5,5,5,5,5,5,5,5,5,5,5,5,5,5,5,5,5,5,5,5,5,5,0,0,0,0,5,5,5,5,5,5
5,5,5,0,0,0,0,0,0,0,5,5,5,5,5,5,5,5,6,6,6,6,5,5,5,5,5,5,5,0,0,0,0,0,5,5,5,5,5,5,5,5,5,5,5,5,5,5,5,5,5,5,5,5,5,5,5,5,5,5,5,5,5,5,5,5,5,5,5,5,5,5,5,5,5,5,5,5,5,5,5,5,5,5,5,5,5,5,5,5,0,0,0,0,5,5,5,5,5,5
5,5,5,5,0,0,0,0,0,0,5,5,5,5,5,5,6,6,6,6,6,6,5,5,5,5,5,5,5,0,0,0,0,5,5,5,5,5,5,5,5,5,5,5,5,5,5,5,5,5,5,5,5,5,5,5,0,0,0,5,5,5,5,5,5,5,5,5,5,5,5,5,5,5,5,5,5,5,5,5,5,5,5,5,5,5,5,5,5,5,0,0,0,5,5,5,5,5,5,5
5,5,5,5,0,0,0,0,0,0,0,5,5,5,5,6,6,6,6,6,6,5,5,5,5,5,5,5,0,0,0,0,0,5,5,5,5,5,5,5,5,5,5,0,0,0,0,0,5,5,5,5,5,5,5,0,0,0,0,0,0,5,5,5,5,5,5,5,5,0,0,0,0,5,5,5,5,5,5,5,5,0,0,0,5,5,5,5,5,5,0,0,0,5,5,5,5,5,5,5
5,5,5,5,5,0,0,0,0,0,0,0,5,5,5,6,6,6,6,6,6,6,5,5,5,5,5,5,0,0,0,0,0,5,5,5,5,5,5,5,5,5,0,0,0,0,0,0,0,5,5,5,5,5,0,0,0,0,0,0,0,0,5,5,5,5,5,5,0,0,0,0,0,0,5,5,5,5,5,0,0,0,0,0,0,0,5,5,5,5,0,0,0,5,5,5,5,5,5,5
5,5,5,5,5,5,0,0,0,0,0,0,5,5,5,6,6,6,6,6,6,6,6,5,5,5,5,0,0,0,0,0,5,5,5,5,5,5,5,5,5,0,0,0,0,0,0,0,0,0,5,5,5,0,0,0,0,0,0,0,0,0,0,0,5,5,5,0,0,0,0,0,0,0,0,5,5,5,0,0,0,0,0,0,0,0,0,0,5,5,5,0,0,0,5,5,5,5,5,5
5,5,5,5,5,5,0,0,0,0,0,0,0,5,5,6,6,6,6,6,6,6,6,5,5,5,0,0,0,0,0,5,5,5,5,5,5,5,5,5,0,0,0,0,5,5,5,0,0,0,5,5,0,0,0,0,5,5,5,0,0,0,0,0,0,5,0,0,0,0,5,5,0,0,0,0,5,0,0,0,0,0,5,0,0,0,0,0,0,5,5,5,0,0,0,5,5,5,5,5
5,5,5,5,5,5,5,0,0,0,0,0,0,5,5,5,6,6,6,6,6,6,5,5,5,5,0,0,0,0,0,5,5,5,5,5,5,5,5,0,0,0,0,5,5,5,5,5,0,0,0,0,0,0,0,5,5,5,5,5,0,0,0,0,0,0,0,0,0,5,5,5,5,0,0,0,0,0,0,0,5,5,5,5,0,0,0,0,0,0,5,5,0,0,0,0,5,5,5,5
5,5,5,5,5,5,5,0,0,0,0,0,0,5,5,5,5,6,6,6,6,6,5,5,0,0,0,0,0,0,0,5,5,5,5,5,5,5,5,0,0,0,0,5,5,5,5,5,0,0,0,0,0,5,5,5,5,5,5,5,5,0,0,0,0,0,0,0,5,5,5,5,5,5,0,0,0,0,0,5,5,5,5,5,5,5,0,0,0,0,0,5,5,0,0,0,5,5,5,5
5,5,5,5,5,5,0,0,0,0,0,0,0,5,5,5,5,5,6,6,6,5,5,5,0,0,0,0,0,0,5,5,5,5,5,5,5,5,5,0,0,0,0,0,5,5,5,5,5,0,0,5,5,5,5,5,5,5,5,5,5,5,5,0,0,0,0,0,5,5,5,5,5,5,5,0,0,0,5,5,5,5,5,5,5,5,5,0,0,0,0,0,0,0,0,0,5,5,5,5
5,5,5,5,5,5,0,0,0,0,0,0,5,5,5,5,5,5,5,5,5,5,5,5,0,0,0,0,0,5,5,5,5,5,5,5,5,5,5,5,5,0,0,0,0,5,5,5,5,5,5,5,5,5,5,5,5,5,5,5,5,5,5,5,5,5,5,5,5,5,5,5,5,5,5,5,5,5,5,5,5,5,5,5,5,5,5,5,0,0,0,0,0,0,0,5,5,5,5,5
5,5,5,5,5,0,0,0,0,0,0,5,5,5,5,5,5,5,5,5,5,5,5,5,0,0,0,0,0,5,5,5,5,5,5,5,5,5,5,5,5,5,0,0,0,0,5,5,5,5,5,5,5,5,5,5,5,5,5,5,5,5,5,5,5,5,5,0,0,5,5,5,5,5,5,5,5,5,5,5,5,5,5,5,5,5,5,5,5,5,0,0,0,0,5,5,5,5,5,5
5,5,5,5,0,0,0,0,0,0,5,5,5,5,5,5,5,5,5,5,5,5,5,5,5,0,0,0,0,0,5,5,5,5,5,5,5,5,5,5,5,5,0,0,0,0,5,5,5,5,6,5,5,5,5,5,0,0,0,5,5,5,5,5,5,0,0,0,0,0,5,5,5,5,5,5,5,5,5,5,5,5,5,5,5,5,5,5,5,5,5,5,5,5,5,5,5,5,5,5
5,5,5,0,0,0,0,0,0,0,5,5,5,5,5,5,5,5,5,5,5,5,5,5,5,5,0,0,0,0,0,5,5,5,5,5,5,5,5,5,5,0,0,0,0,5,5,5,6,6,6,5,5,5,5,0,0,0,0,5,5,5,5,0,0,0,0,0,0,0,0,5,5,5,5,5,5,5,5,5,0,0,0,0,0,5,5,5,5,5,5,5,5,5,5,5,5,5,5,5
5,5,5,0,0,0,0,0,0,5,5,5,5,5,0,0,0,0,5,5,5,5,5,5,5,5,0,0,0,0,0,0,5,5,5,5,5,5,5,5,0,0,0,0,5,5,5,6,6,6,6,5,5,5,0,0,0,0,0,0,5,5,0,0,0,0,0,0,0,0,0,5,5,5,5,5,5,5,5,0,0,0,0,0,0,0,0,5,5,5,5,5,5,5,5,5,5,5,5,5
5,5,5,0,0,0,0,0,0,5,5,5,5,0,0,0,0,0,0,5,5,5,5,5,5,5,5,0,0,0,0,0,5,5,5,5,5,5,5,5,0,0,0,5,5,5,6,6,6,6,5,5,5,0,0,0,5,5,0,0,0,0,0,0,0,5,5,5,0,0,0,0,5,5,5,5,5,5,0,0,0,5,0,0,0,0,0,0,5,5,5,5,5,5,5,5,5,5,5,5
5,5,5,5,0,0,0,0,0,0,5,0,0,0,0,0,0,0,0,0,5,5,5,5,5,5,0,0,0,0,0,0,5,5,5,5,5,5,5,0,0,0,5,5,5,5,5,6,6,5,5,5,0,0,0,5,5,5,5,0,0,0,0,0,5,5,5,5,5,0,0,0,5,5,5,5,5,5,0,0,0,5,5,5,5,0,0,0,0,5,5,5,5,5,5,5,5,5,5,5
5,5,5,5,0,0,0,0,0,0,0,0,0,0,0,0,0,0,0,0,0,5,5,5,5,0,0,0,0,0,0,0,5,5,5,5,5,5,0,0,0,0,5,5,5,5,5,5,5,5,5,5,0,0,0,5,5,5,5,5,0,0,0,5,5,5,5,5,0,0,0,0,5,5,5,5,5,5,0,0,0,0,5,5,5,5,0,0,0,0,5,5,5,5,5,5,5,5,5,5
5,5,5,5,5,0,0,0,0,0,0,0,0,0,0,0,0,0,0,0,0,0,0,5,0,0,0,0,0,0,0,5,5,5,5,5,5,5,0,0,0,0,5,5,5,5,5,5,5,5,5,5,0,0,0,5,5,5,5,5,5,5,5,5,5,5,5,0,0,0,0,5,5,5,5,5,5,5,5,0,0,0,5,5,5,5,5,0,0,0,0,5,5,5,5,5,5,5,5,0
5,5,5,5,5,0,0,0,0,0,0,0,0,0,5,5,5,0,0,0,0,0,0,0,0,0,0,0,0,0,0,5,5,5,5,5,5,5,0,0,0,5,5,5,5,5,0,0,5,5,5,5,5,0,0,0,5,5,5,5,5,5,5,5,5,5,0,0,0,0,5,5,5,5,5,5,5,5,5,5,0,0,5,5,5,5,5,5,0,0,0,0,5,5,5,5,5,0,0,0
5,5,5,5,5,5,0,0,0,0,0,0,5,5,5,5,5,5,5,0,0,0,0,0,0,0,0,0,0,0,5,5,5,5,5,5,5,0,0,0,0,5,5,5,5,0,0,0,0,5,5,5,5,5,0,0,0,5,5,5,5,5,5,5,5,5,0,0,0,5,5,5,5,5,0,0,0,5,5,0,0,0,5,5,5,5,5,5,5,0,0,0,5,5,5,5,0,0,0,0
5,5,5,5,5,5,5,0,0,0,5,5,5,5,5,5,5,5,5,5,0,0,0,0,0,0,0,0,5,5,5,5,5,5,5,5,5,0,0,0,0,0,5,5,0,0,0,0,0,5,5,5,5,5,0,0,0,5,5,5,5,5,5,5,5,5,0,0,0,5,5,5,5,0,0,0,0,0,0,0,0,0,5,5,5,5,5,5,5,0,0,0,0,1018,0,0,0,0,0,0
5,5,5,5,5,5,5,5,5,5,5,5,5,5,5,5,5,5,5,5,5,0,0,0,0,0,5,5,5,5,5,5,5,5,5,5,5,0,0,0,0,0,0,0,0,0,0,0,0,0,5,5,5,0,0,0,5,5,5,5,5,5,5,5,5,5,0,0,0,0,5,5,0,0,0,0,0,0,0,0,0,5,5,5,5,5,5,5,5,5,0,0,0,1018,0,0,0,0,0,0
5,5,5,5,5,5,5,5,5,5,5,5,5,5,5,5,5,5,5,5,5,5,5,5,5,5,5,5,5,5,5,5,5,5,5,5,5,5,0,0,0,0,0,0,0,0,5,0,0,0,0,0,0,0,0,5,5,5,5,5,5,5,5,5,5,5,0,0,0,0,0,0,0,0,0,5,0,0,0,0,5,5,5,5,5,5,5,5,5,5,5,0,0,1018,0,0,5,5,5,0
5,5,5,5,5,5,5,5,5,5,5,5,5,5,5,5,5,5,5,5,5,5,5,5,5,5,5,5,5,5,5,5,5,5,5,5,5,5,5,0,0,0,0,0,0,5,5,5,0,0,0,0,0,0,0,5,5,5,5,5,5,5,5,5,5,5,5,0,0,0,0,0,0,0,5,5,5,0,0,5,5,5,5,5,5,5,5,5,5,5,5,5,0,1018,0,5,5,5,5,5
5,5,5,5,5,5,5,5,5,5,5,5,5,5,5,5,5,5,5,5,5,5,5,5,5,5,5,5,5,5,5,5,5,5,5,5,5,5,5,5,0,0,0,0,0,5,5,5,5,0,0,0,0,0,5,5,5,5,5,5,5,5,5,5,5,5,5,5,5,0,0,0,5,5,5,5,5,5,5,5,5,5,5,5,5,5,5,5,5,5,5,5,5,5,5,5,5,5,5,5
5,5,5,5,5,5,5,5,5,5,5,5,5,5,5,5,5,5,5,5,5,5,5,5,5,5,5,5,5,5,5,5,5,5,5,5,5,5,5,5,5,5,5,5,5,5,5,5,5,5,5,5,5,5,5,5,5,5,5,5,5,5,5,5,5,5,5,5,5,5,5,5,5,5,5,5,5,5,5,5,5,5,5,5,5,5,5,5,5,5,5,5,5,5,5,5,5,5,5,5
5,5,5,5,5,5,5,5,5,5,5,5,5,5,5,5,5,5,5,5,5,5,5,5,5,5,5,5,5,5,5,5,5,5,5,5,5,5,5,5,5,5,5,5,5,5,5,5,5,5,5,5,5,5,5,5,5,5,5,5,5,5,5,5,5,5,5,5,5,5,5,5,5,5,5,5,5,5,5,5,5,5,5,5,5,5,5,5,5,5,5,5,5,5,5,5,5,5,5,5
