401,401,401,401,401,401,401,401,401,401,401,401,401,401,401,401,401,401,401,401,401,401,401,401,401,401,401,401,401,401,401,401,401,401,401,401,401,401,401,401,401,401,401,401,400,400,400,400,400,400,400,400,400,401,401,401,401,401,401,401,401,401,401,401,401,401,401,401,401,401,401,401,401,401,401,401,401,401,401,401,401,401,401,401,401,401,401,401,401,401,401,401,401,401,401,401,401,401,401,401
401,401,401,401,401,401,401,401,401,401,401,401,401,401,401,401,401,401,401,401,401,401,401,401,401,401,401,401,401,401,401,401,401,401,401,401,401,401,401,401,401,401,401,401,400,400,400,400,400,400,400,400,400,401,401,401,401,401,401,401,401,401,401,401,401,401,401,401,401,401,401,401,401,401,401,401,401,401,401,401,401,401,401,401,401,401,401,401,401,401,401,401,401,401,401,401,401,401,401,401
401,411,412,413,411,412,413,411,412,413,411,412,413,411,412,413,411,412,413,411,412,413,411,412,413,411,412,413,411,412,413,411,412,413,411,412,413,411,412,413,411,412,413,411,400,400,400,400,400,400,400,400,400,412,413,411,412,413,411,412,413,411,412,413,411,412,413,411,412,413,411,412,413,411,412,413,411,412,413,411,412,413,411,412,413,411,412,413,411,412,413,411,412,413,411,412,413,411,412,401
401,411,412,400,400,400,400,400,400,400,400,400,400,400,400,400,400,400,400,400,400,400,400,400,400,400,400,400,400,400,400,400,400,400,400,400,400,400,400,400,400,400,400,400,400,400,400,400,400,400,400,400,400,400,400,400,400,400,400,400,400,400,400,400,400,400,400,400,400,400,400,400,400,400,400,400,400,400,400,400,400,400,400,400,400,400,400,400,400,400,400,400,400,400,400,400,400,411,412,401
401,412,413,400,400,400,400,400,400,400,400,400,400,400,400,400,400,400,400,400,400,400,400,400,400,400,400,400,400,400,400,400,400,400,400,400,400,400,400,400,400,400,400,400,400,400,400,400,400,400,400,400,400,400,400,400,400,400,400,400,400,400,400,400,400,400,400,400,400,400,400,400,400,400,400,400,400,400,400,400,400,400,400,400,400,400,400,400,400,400,400,400,400,400,400,400,400,412,413,401
401,413,411,400,400,400,400,400,400,400,400,400,400,400,400,400,400,400,400,400,400,400,400,400,400,400,400,400,400,400,400,400,400,400,400,400,400,400,400,400,400,400,400,400,400,400,400,400,400,400,400,400,400,400,400,400,400,400,400,400,400,400,400,400,400,400,400,400,400,400,400,400,400,400,400,400,400,400,400,400,400,400,400,400,400,400,400,400,400,400,400,400,400,400,400,400,400,413,411,401
401,411,412,400,401,401,401,401,401,501,401,401,401,401,400,400,400,400,400,400,400,400,401,401,401,401,401,401,401,401,401,401,401,401,401,400,400,400,400,400,400,400,400,400,400,400,400,400,400,400,400,400,400,400,400,400,400,400,400,400,400,400,400,400,400,400,400,400,400,400,401,401,401,401,401,401,401,401,401,401,400,400,400,400,400,400,400,400,400,400,400,400,400,400,400,400,400,411,412,401
401,412,413,400,401,401,401,401,401,401,401,401,401,401,400,400,400,400,400,400,400,400,401,401,401,401,401,401,401,401,401,401,401,401,401,400,400,400,400,400,400,400,400,400,400,400,400,400,400,400,400,400,400,400,400,400,400,400,400,400,400,400,400,400,400,400,400,400,400,400,401,400,400,400,400,401,401,401,401,401,400,400,400,400,400,400,400,400,400,400,400,400,400,400,400,400,400,412,413,401
401,413,411,400,401,401,401,401,401,401,401,401,401,401,400,400,400,400,400,400,400,400,401,401,401,401,401,401,401,401,401,401,401,401,401,400,400,400,400,400,400,400,400,400,400,1,1,1,1,1,1,1,1,1,1,400,400,400,400,400,400,400,400,400,400,400,400,400,400,400,401,400,400,400,400,401,401,401,401,401,400,400,400,400,400,400,400,400,400,400,400,400,400,400,400,400,400,400,400,400
401,411,412,400,401,401,401,401,401,401,401,401,401,401,400,400,400,400,400,400,400,400,401,401,401,401,401,401,401,401,401,401,401,401,401,400,400,400,400,400,400,400,400,400,400,1,0,0,0,0,0,1,0,0,1,400,400,400,400,400,400,400,400,400,400,400,400,400,400,400,401,400,400,400,400,401,401,401,401,401,400,400,400,400,400,400,400,400,400,400,400,400,400,400,400,400,400,400,400,400
401,412,413,400,401,401,401,401,401,401,401,401,401,401,400,400,400,400,400,400,400,400,401,401,401,401,401,401,401,401,401,401,401,401,401,400,400,400,400,400,400,411,412,413,411,1,0,0,0,0,0,1,0,0,1,413,400,400,400,400,400,400,400,400,400,400,400,400,400,400,401,400,400,400,400,401,401,401,401,500,400,400,400,400,400,400,400,400,400,400,400,400,400,400,400,400,400,400,400,400
401,413,411,400,401,401,401,401,401,401,401,401,401,401,400,400,400,400,400,400,400,400,401,401,401,401,401,401,401,401,401,401,401,401,401,400,400,400,400,400,400,412,413,411,412,1,1,1,1,1,0,1,0,0,1,411,400,400,400,400,400,400,400,400,400,400,400,400,400,400,401,400,400,400,400,401,401,401,401,500,400,400,400,400,401,401,401,401,401,401,401,401,401,401,400,400,400,400,400,400
401,411,412,400,401,401,401,401,401,401,401,401,401,401,400,400,400,400,400,400,400,400,401,401,401,401,401,401,401,401,401,401,401,401,401,400,400,400,400,400,400,413,411,412,413,1,0,0,0,0,0,1,0,0,1,412,400,400,400,400,400,400,400,400,400,400,400,400,400,400,401,400,400,400,400,401,401,401,401,401,400,400,400,400,401,401,401,401,401,401,401,401,401,401,400,400,400,400,400,400
401,412,413,400,401,401,401,401,401,401,401,401,401,401,400,400,400,400,400,400,400,400,401,401,401,401,401,401,401,401,401,401,401,401,500,400,400,400,400,400,400,411,412,413,406,1,0,0,0,0,0,0,0,0,1,413,400,400,400,400,400,400,400,400,400,400,400,400,400,400,401,400,400,400,400,401,401,401,401,401,400,400,400,400,401,401,401,401,401,401,401,401,401,401,400,400,400,400,400,400
401,413,411,400,401,401,401,401,401,401,401,401,401,401,400,400,400,400,400,400,400,400,401,401,401,401,401,401,401,401,401,401,401,401,500,400,400,400,400,400,400,412,413,411,406,1,1,1,1,1,0,0,0,0,1,411,400,400,400,400,400,400,400,400,400,400,400,400,400,400,401,400,400,400,400,401,401,401,401,401,400,400,400,400,401,401,401,401,401,401,401,401,401,401,400,400,400,400,400,400
401,411,412,400,401,401,401,401,401,401,401,401,401,401,400,400,400,400,400,400,400,400,401,401,401,401,401,401,401,401,401,401,401,401,401,400,400,400,400,400,400,413,411,412,406,1,0,0,0,0,0,0,0,0,1,412,400,400,400,400,400,400,400,400,400,400,400,400,400,400,401,400,400,400,400,401,401,401,401,401,400,400,400,400,401,401,401,401,401,401,401,401,401,401,400,400,400,400,400,400
401,412,413,400,401,401,401,401,401,401,401,401,401,401,400,400,400,400,400,400,400,400,401,401,401,401,401,401,401,401,401,401,401,401,401,400,400,400,400,400,400,411,412,413,406,1,0,0,0,0,0,0,0,0,100,413,400,400,400,400,400,400,400,400,400,400,400,400,400,400,401,401,401,401,401,401,401,401,401,401,400,400,400,400,401,401,401,401,401,401,401,401,401,401,400,400,400,400,400,400
401,413,411,400,400,400,400,400,400,400,400,400,400,400,400,400,400,400,400,400,400,400,401,401,401,401,401,401,401,401,401,401,401,401,401,400,400,400,400,400,400,412,413,411,406,1,1,1,1,1,0,0,0,0,100,411,400,400,400,400,400,400,400,400,400,400,400,400,400,400,400,400,400,400,400,400,400,400,400,400,400,400,400,400,401,401,401,401,401,401,401,401,401,401,400,400,400,413,411,401
401,411,412,400,400,400,400,400,400,400,400,400,400,400,400,400,400,400,400,400,400,400,401,401,401,401,401,401,401,401,401,401,401,401,401,400,400,400,400,400,400,413,411,412,406,1,0,0,0,0,0,0,0,0,100,412,400,400,400,400,400,400,400,400,400,400,400,400,400,400,400,400,400,400,400,400,400,400,400,400,400,400,400,400,401,401,401,401,401,401,401,401,401,401,400,400,400,411,412,401
401,412,413,400,400,400,400,400,400,400,400,400,400,400,400,400,400,400,400,400,400,400,401,401,401,401,401,401,401,401,401,401,401,401,401,400,400,400,400,400,400,411,412,413,406,0,0,0,0,0,0,0,0,0,100,413,400,400,400,400,400,400,400,400,400,400,400,400,400,400,400,400,400,400,400,400,400,400,400,400,400,400,400,400,401,401,401,401,401,401,401,401,401,401,400,400,400,412,413,401
401,413,411,400,400,400,400,400,400,400,400,400,400,400,400,400,400,400,400,400,400,400,401,401,401,401,401,401,401,401,401,401,401,401,401,400,400,400,400,400,400,412,413,411,406,1,1,1,1,1,0,0,0,0,1,411,400,400,400,400,400,400,400,400,400,400,400,400,400,400,400,400,400,400,400,400,400,400,400,400,400,400,400,400,401,401,401,401,401,401,401,401,401,401,400,400,400,413,411,401
401,411,412,400,400,400,400,400,400,400,400,400,400,400,400,400,400,400,400,400,400,400,401,401,401,401,401,401,401,401,401,401,401,401,401,400,400,400,400,400,400,413,411,412,406,1,0,0,0,0,0,0,0,0,1,412,400,400,400,400,400,400,400,400,400,400,400,400,400,400,400,400,400,400,400,400,400,400,400,400,400,400,400,400,401,401,401,401,500,401,401,401,401,401,400,400,400,411,412,401
401,412,413,400,400,400,400,400,400,401,401,401,401,401,401,401,401,401,401,400,400,400,401,401,401,401,401,401,401,401,401,401,401,401,401,400,400,400,400,400,400,411,412,413,406,1,0,0,0,0,0,0,0,0,1,413,400,400,400,400,401,401,401,401,401,401,401,401,401,401,400,400,400,400,400,400,400,400,400,400,400,400,400,400,400,400,400,400,400,400,400,400,400,400,400,400,400,412,406,406
401,413,411,400,400,400,400,400,400,401,401,401,401,401,401,401,401,401,401,400,400,400,401,401,401,401,401,401,401,401,401,401,401,401,401,400,400,400,400,400,400,412,413,411,406,1,1,1,1,1,0,0,0,0,1,411,400,400,400,400,401,401,401,401,401,401,401,401,401,401,400,400,400,400,400,400,400,400,400,400,400,400,400,400,400,400,400,400,400,400,400,400,400,400,400,400,400,406,406,406
401,411,412,400,400,400,400,400,400,401,401,401,401,401,401,401,401,401,401,400,400,400,400,400,400,400,400,400,400,400,400,400,400,400,400,400,400,400,400,400,400,413,411,412,406,1,0,0,0,0,0,0,0,0,1,412,400,400,400,400,401,401,401,401,401,401,401,401,401,401,400,400,400,400,400,400,400,400,400,400,400,400,400,400,400,400,400,400,400,400,400,400,400,400,400,406,406,406,406,406
401,412,413,400,400,400,400,400,400,401,401,401,401,401,401,401,401,401,401,400,400,400,400,400,400,400,400,400,400,400,400,400,400,400,400,400,400,400,400,400,400,411,412,413,411,1,0,0,0,0,0,0,0,0,1,413,400,400,400,400,401,401,401,401,401,401,401,401,401,401,400,400,400,400,400,400,400,400,400,400,400,400,400,400,400,400,400,400,400,400,400,400,400,400,400,406,406,406,406,406
401,413,411,400,400,400,400,400,400,401,401,401,401,401,401,401,401,401,401,400,400,400,400,400,400,400,400,400,400,400,400,400,400,400,400,400,400,400,400,400,400,412,413,411,412,1,1,1,1,1,0,0,0,0,1,411,400,400,400,400,401,401,401,401,401,401,401,401,401,401,400,400,400,400,400,400,400,400,400,400,400,400,400,400,400,400,400,400,400,400,400,400,400,400,406,406,406,406,406,406
401,411,412,400,400,400,400,400,400,401,401,401,401,401,401,401,401,401,401,400,400,400,401,401,401,401,401,401,401,401,401,401,400,400,400,400,400,400,400,400,400,413,411,412,413,1,0,0,0,100,0,1,0,0,1,412,400,400,400,400,401,401,401,401,401,401,401,401,401,401,400,400,400,400,400,400,400,400,400,400,400,400,400,400,400,400,400,400,400,400,400,400,400,400,406,406,406,406,406,406
401,412,413,400,400,400,400,400,400,401,401,401,401,401,401,401,401,401,401,400,400,400,401,401,401,401,401,401,401,401,401,401,400,400,400,400,400,400,400,400,400,400,400,400,400,1,0,0,0,1,0,1,0,0,1,400,400,400,400,400,401,401,401,401,401,401,401,401,401,401,400,400,400,400,400,400,400,400,400,400,400,400,400,400,400,400,400,400,400,400,400,400,400,400,406,406,406,406,406,406
401,413,411,400,400,400,400,400,400,401,401,401,401,401,401,401,401,401,401,400,400,400,401,401,401,401,401,401,401,401,401,401,400,400,400,400,400,400,400,400,400,400,400,400,400,1,0,0,0,1,0,1,0,0,1,400,400,400,400,400,401,401,401,401,401,401,401,401,401,401,400,400,400,400,400,400,400,400,400,400,400,400,400,400,400,400,400,400,400,400,400,400,406,406,406,406,406,406,406,406
401,411,412,400,400,400,400,400,400,401,401,401,401,401,401,401,401,401,401,400,400,400,401,401,401,401,401,401,401,401,401,401,400,400,400,400,400,400,400,400,400,400,400,400,400,1,0,0,0,0,0,1,0,0,1,400,400,400,400,400,401,401,401,401,401,401,401,401,401,401,400,400,400,400,400,400,400,400,400,400,400,400,400,400,400,400,400,400,400,400,400,400,406,406,406,406,406,406,406,406
401,412,413,400,400,400,400,400,400,401,401,401,401,401,401,401,401,401,401,400,400,400,401,401,401,401,401,401,401,401,401,401,400,400,400,400,400,400,400,400,400,400,400,400,400,1,1,1,1,1,1,1,1,1,1,400,400,400,400,400,401,401,401,401,401,401,401,401,401,401,400,400,400,400,400,400,400,400,400,400,400,400,400,400,400,400,400,400,400,400,400,400,406,406,406,406,406,406,406,406
401,413,411,400,400,400,400,400,400,401,500,401,401,401,401,401,401,500,401,400,400,400,401,401,401,401,401,401,401,401,401,401,400,400,400,400,400,400,400,400,400,400,400,412,413,411,412,413,411,412,413,411,412,413,400,400,400,400,400,400,401,401,401,401,501,401,401,401,401,401,400,400,400,400,400,400,400,400,400,400,400,400,400,400,400,400,400,400,400,400,400,400,406,406,406,406,406,406,406,406
401,411,412,400,400,400,400,400,400,400,400,400,400,400,400,400,400,400,400,400,400,400,401,401,401,401,401,401,401,401,401,401,400,400,400,400,400,400,400,400,400,400,411,412,413,411,412,413,411,412,413,411,412,413,411,400,400,400,400,400,400,400,400,400,400,400,400,400,400,400,400,400,400,400,400,400,400,400,400,400,400,400,400,400,400,400,400,400,400,400,400,406,406,406,406,406,406,406,406,406
401,412,413,400,400,400,400,400,400,400,400,400,400,400,400,400,400,400,400,400,400,400,401,401,401,401,401,401,401,401,401,401,400,400,400,400,400,400,400,400,400,412,413,411,412,413,411,412,413,411,412,413,411,412,413,411,400,400,400,400,400,400,400,400,400,400,400,400,400,400,400,400,400,400,400,400,400,400,400,400,400,400,400,400,400,400,400,400,400,400,406,406,406,406,406,406,406,406,406,406
401,413,411,400,400,400,400,400,400,400,400,400,400,400,400,400,400,400,400,400,400,400,401,401,500,401,401,401,401,401,401,401,400,400,400,400,400,400,400,400,411,412,413,411,412,413,411,412,413,411,412,413,411,412,413,411,412,400,400,400,400,400,400,400,400,400,400,400,400,400,400,400,400,400,400,400,400,400,400,400,400,400,400,400,400,400,400,400,400,400,406,406,406,406,406,406,406,406,406,405
401,411,412,400,400,400,400,400,400,400,400,400,400,400,400,400,400,400,400,400,400,400,400,400,400,400,400,400,400,400,400,400,400,400,400,400,400,400,400,412,413,411,412,413,411,412,413,411,412,413,411,412,413,411,412,413,411,412,400,400,400,400,400,400,400,400,400,400,400,400,400,400,400,400,400,400,400,400,400,400,400,400,400,400,400,400,400,400,400,400,406,406,406,406,406,406,406,406,406,405
401,412,413,400,400,400,400,400,400,400,400,400,400,400,400,400,400,400,400,400,400,400,400,400,400,400,400,400,400,400,400,400,400,400,400,400,400,400,411,412,413,411,412,413,411,412,413,411,412,413,411,412,413,411,412,413,411,412,413,400,400,400,400,400,400,400,400,400,400,400,400,400,400,400,400,400,400,400,400,400,400,400,400,400,400,400,400,400,400,406,406,406,406,406,406,406,406,406,405,405
401,401,401,401,401,401,401,401,401,401,401,401,401,401,401,401,401,401,401,401,401,401,401,401,401,401,401,401,401,401,401,401,401,401,401,401,401,401,401,401,401,401,401,401,401,401,401,401,401,401,401,401,401,401,401,401,401,401,401,401,401,401,401,401,401,401,401,401,401,401,401,401,401,401,400,400,400,400,400,400,400,400,400,400,401,401,401,401,401,406,406,406,406,406,406,406,406,406,405,405
401,401,401,401,401,401,401,401,401,401,401,401,401,401,401,401,401,401,401,401,401,401,401,401,401,401,401,401,401,401,401,401,401,401,401,401,401,401,401,401,401,401,401,401,401,401,401,401,401,401,401,401,401,401,401,401,401,401,401,401,401,401,401,401,401,401,401,401,401,401,401,401,401,401,400,400,400,400,400,400,400,400,400,400,401,401,401,401,401,406,406,406,406,406,406,406,406,406,405,405
